1111111111111111
100C000X000C0001
1010111011101101
101000000C000101
1010111111100101
1C00000C00X00C01
1010111111100101
10100C0X0C000101
1010111011101101
1E000000C00000P1
1111111111111111