111111111111111111111111111111
1P000C00000X0000C0000C00000001
101011011111011011111110101101
1000110000010X0000000010001101
101011011101111111011110101101
10100C00010000C000010000001101
111011110101111111010111101111
1C0010000X0000000000010000XE01
101011111101111111110111101101
10001000C0000000C000000011X001
101110101111011111101011110101
1000001010000C0000101000000101
101110101011110111101011110101
10C00010100X000000101000C00001
111111111111111111111111111111